NO textures/moon.xpm
SO textures/rocks.xpm
WE textures/stone.xpm
EA                                              textures/dirt.xpm


C 125,    246,255
F 120,120,120

111111111111111
11111111111111111111
10000000000000000001
10000011100000000001
10000000000000000001
10000000000000000001
10000000000000000001
10000000000000000001
10000000000001000001
10000000000001000001
10000000000001000001
10001111000001000E01
10001000000001000001
100010000000000000011111
10001000000000000001
11111111111111111111