NO textures/stone.xpm
SO textures/stone.xpm
WE textures/dirt.xpm
EA textures/dirt.xpm

F 120,   120,120
C 125,246,255

11111111111111111111
11111111111111111111
10000000000000000001
10000011100000000001
10000000000000000001
10000000000000000001
10000000000000000001
10000000000000000001
100000000000010000N1
10000000000001000001
10000000000001000001
10001111000001000001
10001000000001000001
10001000000000000001
10001000000000000001
11111111111111111111