11111111111
10000111101
10000000001
1N000000001
11111111111