111111
100101
111001
1100N 1
111111